................
................
................
................
................
................
...........!....
...!.......@....
...@..!....@!...
...@!.@....@@...
...@@.@....@@...
QQQQQQQQQQQQQQQQ
SSSSSSSSSSSSSSSS