################
#..............#
#.{.....`.}....#
#..............#
#..............#
#..............#
#..............#
#..............#
#..............#
#..............#
#v..uv.~.....uv#
#..............#
################