+23+++++++++++++
+23............+
+01............+
+@@..i.i.i.....+
+...i.i.i..01k.+
+..........23..+
+++++++++++++..+
+..............+
+.............j+
+..YY.i.i.i.i..+
+..01..i.i.i.i.+
+..23..........+
+++23+++++++++++